          SO ./so_good_so.xpm
                  NO ./no_good_no.xpm
EA . /ea_good_ea.xpm
WE ./we_good_we.xpm

F 254,222,255
C 225,12,255


11111111111111111111111111111
10100010001111111111111111111
10000101100000000000000001111
10011100000000000000000001111
10000000000000000000000001111
10111000000000000000000001111
10000000000000000000000001111
10001110000000001000100001111
10000001000000000000100001111
10000000000000000000000001111
10000000000000000000000001111
10000000000000000000000001111
10000000000000000000000001111
10000000000000000000000001111
10000000000000000000000001111
1000000E000000000000100001111
10000000000000000000000001111
10000000000000000000000001111
11111111111111111111111111111