
          SO ./so_good_so.xpm
                  NO ./no_good_no.xpm
EA . /ea_good_ea.xpm
WE ./we_good_we.xpm

F 254,222,255
C 225,12,255

1111111111111111111111111
10000N0000110000000000001
1011000001110000010000011
1001000000000000000000011
1111111111000001110000101
1000000100111110001110111
1111011111111101110000001
1111011111110011011101011
1100000011010101110000001
1000000000000011000000101
1000000000000000110101001
1100000111010101110101111
1111011111101011010110101
1111111111111111111111111