
          SO ./so_good_so.xpm
                  NO ./no_good_no.xpm
EA . /ea_good_ea.xpm
WE ./we_good_we.xpm

F 254,222,255
C 225,12,255

111111111111
1010001N0001
100001011001
100111000001
100000000001
101110000001
100000000001
100011100001
100000000001
100000000001
100000000001
111111111111